XXXXXXXXXXXX
XX...X.....X
XX.....GG..X
XXJJJ..GGXXX
X.J....MXXXX
X...X...XXXX
XXXXXXXXXXXX