XXXXXXXXXXXX
XX...X.....X
XX...X.GG..X
XXJJJ.XGGXXX
X.J....MXXXX
X...X...XXXX
XXXXXXXXXXXX